DefaultPack/
40
20
........................................
........................................
....###############.........#######.....
....#.............##...................#
....#..............##..................#
....#...............##.................#
....#.................####....##........
....#...........................####....
....############........................
........................................
..........................##############
........................................
..............##########................
........................................
........................................
.....####...............................
.....####################.........P.....
.....####################...............
...............................#####....
........................................
