DefaultPack/
14
12
....P...##....
..............
..............
.......#######
.......#......
..######......
..............
..............
.............#
............##
#####.....####
....##########
